8,10
1,1
########
# ##   #
# ## ###
# ## ###
# ## ###
#    ###
# ######
# ######
########
########